00000000000000000000000000000000
00000000100000000000000000000000
00000000000000000000000072100000
00000000000111110000000000000000
01919000000000000000000000000000
00000000000000000000000011111000
00000000000000000000000000000000
00777000000000000111110000000000
00000000000000000000000000000000
00000000001111100000001111000000
00000010000000000000000000000000
11111111111111111111111111111111