1011111111
1010000101
1000110101
1010000001
1110111111
